{
    "width": 15,
    "heigh": 15,
    "map": [ "...............",
             "...............",
             "...............",
             ".   ...gg......",
             ".   b b g......",
             "..... .  ......",
             "..... . .......",
             ".... b  .......",
             "...   . .......",
             "s    .. .......",
             "...... b.......",
             "......    .....",
             "...... g. .....",
             "......... .....",
             ".........x....."
    ]
}
